R 1280 720
NO ./visuals/tex_bluestone.xpm
SO ./visuals/tex_eagle.xpm
WE ./visuals/tex_greystone.xpm
EA ./visuals/tex_mossy.xpm

S ./visuals/sprt_barrel.xpm
F 169,169,169
C 70,70,70


        1111111111111111111111111
        1000000000110000000000001
        1011000001110000002000001
        1001000000000000000000001
111111111011000001110000000000001
100000000011000001110111111111111
11110111111111011100000010201
11110111111111011101010012021
11000000110101011100000000001
10002000000000000000000010001
10000000000000001101010010001
11000001110101011111011110N0111
11110111 1110101 101111010001
11111111 1111111 111111111111
