R 1280 720
NO ./visuals/tex_wood.xpm
SO ./visuals/tex_bluestone.xpm
WE ./visuals/tex_greystone.xpm
EA ./visuals/tex_eagle.xpm

S ./visuals/sprt_barrel.xpm
F 169,169,169
C 70,70,70

111111     1  
1001011   101
102001     1
1100W1   
111111


111111
100101
100101
100001
10N011
111111


111
1N1
111

111111111111111111111111
100000000000000000000001
1000000000000S0000000001
100000000000000000000001
100000111110000101010001
100000100010000000000001
100000100010000100010001
100000100010000000000001
100000110110000101010001
100000000000000000000001
100000000000000000000001
100000000000000000000001
100000000000000000000001
100000000000000000000001
100000000000000000000001
100000000000000000000001
111111111000000000000001
110100001000000000000001
110000101000000000000001
110100001000000000000001
110111111000000000000001
110000000000000000000001
111111111000000000000001
111111111111111111111111




11111111111111111111111111111
10000000001100000000000000001
10110000011100000020000010001
10W10000000000000000000010001
10110000011100000000000010001
10000000001100000111011110001
11110111111111011100000010001
11110111111111011101010010001
11000000110101011100000010001
10002000000000001100000010001
10000000000000001101010010001
11000000110101011111011110001
11110111111101011111011110001
11111111111111111111111111111

        1111111111111111111111111
        1000000000110000000000001
        1011000001110000002000001
        1001000000000000000000001
111111111011000001110000000000001
100000000011000001110111111111111
11110111111111011100000010001
11110111111111011101010010001
11000000110101011100000000001
10002000000000001100000010001
10000000000000001101010010001
11000001110101011111011110N0111
11110111 1110101 101111010001
11111111 1111111 111111111111
