R 1280 720
NO ./visuals/tex_wood.xpm
SO ./visuals/tex_bluestone.xpm
WE ./visuals/tex_greystone.xpm
EA ./visuals/tex_eagle.xpm

S ./visuals/sprt_barrel.xpm
F 169,169,169
C 70,70,70

1111111
1110111
1200021
1000001
1002001
1000N01
1200021
1111111

11111111111
10000000001
10011111001
10000000001
10100200101
10102220101
10100200101
10000000001
10011111001
100000000N1
11111111111
