R 1280 720   
NO ./visuals/tex_dauphin.xpm
SO ./visuals/tex_dauphin.xpm
WE ./visuals/tex_dodo.xpm
EA ./visuals/tex_dodo.xpm

S ./visuals/tex_wallpaper.xpm
F 169,169,169
C 70,70,70

11111111111111111111111111111
10000000001100000000000000001   
10110000011100000020000010001
10010000000000000000000010001
10110000011100000000000010001
10000000001100000111011110001
11110111111111011100000010001
11110111111111011101010010001
11000000110101011100000010001
100000000000N0001100000010001
10000000000000001101010010001
11000000110101011111011110001
11110111111101011111011110001
11111111111111111111111111111
